NO 			./textures/wall_0.xpm


		 	 	 	 	 	 	 	 	                  SO ./textures/wall_0.xpm
WE 	./textures/wall_1.xpm
EA ./textures/wall_1.xpm
C 65,240,255
F 71,19,0000021
11     
1
1111111111111111111111111111111111
100000000010000000000000000000000111
1000000111000000000000000000000000001
100000000010000000000000000000011111
1000E00DDD00000000000000000000000001    
100000011100000000000000000000000001
10000001 100000000000000000000000001
100000011100000000000000000000000001
111111111111111111111111111111111111
11111111111							1
10000000011							1
11111111111							1