NO 			./textures/bluestone.xpm


		 	 	 	SO ./textures/greystone.xpm
WE 	./textures/eagle.xpm
EA ./textures/redbrick.xpm
C 65,240,255
F 71,19,0000021

11     
					                            1	
1
11111111111111111111111111111111111
100000000010000000000000000000000001 
100000000010000000000000000000000001  1
1000000111000000000000000000000000001
1000E00DDD00000000000000000000000001    
10000001110000000000000000000000001
100000000000000000000000000000000001
100000000000000000000000000000000001
1111D1111111111111111111111111111111
1111D111111							1
10000000011							1
11111111111							1