NO 			./textures/bluestone.xpm


		 	 	 	SO ./textures/greystone.xpm
WE 	./textures/eagle.xpm
EA ./textures/redbrick.xpm
C 65,240,255
F 71,19,0000021

11
1
1111111111111111111111111111111111111
10W0000000000010000D00000000000000001
1011111111111011111111101111111111101
1D1000D0000010000000001000D0000000101
1010111111101111111010101111111110101
1010100D00100D000010101000D0000010101
10101111011111111010101111111110101D1
101000D1D1000D001010100000D0001010101
11111011D10111101011101111111010D0101
10001000010100001000000000001D101D101
1010111111010111111101111101101010101
1010000000000000000001000000101010101
11111111111D1111011111111111101D101D1
1010111111011111D11111111101101010101
1010000000000000100000000000101000101
1010111111111111111111111111101011101
100000000000000D000000000101000000001
1111001101D11111D11D1D1111D1111101111
1111D1111101D111D101101110001111D1111
1000000000000010000000000000000000001
1D11111111111D111111111D11111111111D1
10100000000010000000001000000000D0101
101D111111101111111D1D1D1111111110101
10101000D01000000010101000D00000101D1
101D111111111111101010111111111010101
10100001010000001D1010000000001010101
11111011D101111D101110111111101010101
100010D001010000100D000000001D1D1D1D1
101011111101D1111111011111011010101D1
1D1000D0000100D00000010000001D1010101
10101111111111111111111111D1101D1D1D1
1010000D0000000D0000D00000001D1000101
1010111111111111111111111111101011101
1000000000000000000000000000000000001
1111111111111111111111111111111111111